----------
----------
----------
-########-
---####---
-########-
--######--
-########-
----------
----------