----------
-#------#-
-##----##-
-##-##-##-
-##-##-##-
-##-##-##-
-##-##-##-
-##-##-##-
----------
----------